******d******
*r*********r*
d***********d
*r*********r*
******d******